...###
..##.#.######
.##..###....#
##..........#
#...@..#....#
###..###....#
..#..#......#
.##.##.#.####
.#......##
.#.....##
#########